0	0	0	0	0	0	0	0	0	0	0	0	0	0	0	0	0	0	0	0	0	0	0	0	
0	-1	-1	1	2	1	2	8	-1	-1	-1	8	3	3	3	3	3	3	-1	-1	-1	-1	-1	0	
0	6	-1	6	3	6	3	7	-1	-1	-1	7	4	2	4	2	4	2	-1	-1	-1	-1	-1	0	
0	3	-1	2	1	2	1	8	-1	-1	-1	8	2	1	2	1	2	1	-1	-1	-1	-1	-1	0	
0	6	3	6	3	6	3	7	-1	-1	-1	7	4	3	4	3	4	3	-1	-1	-1	-1	-1	0	
0	1	2	1	2	1	2	8	-1	-1	-1	8	1	2	1	2	1	2	-1	-1	-1	-1	-1	0	
0	6	1	6	1	6	1	7	-1	-1	-1	-1	4	3	4	3	4	3	-1	-1	-1	-1	-1	0	
0	2	1	2	1	2	1	7	-1	-1	-1	7	2	1	2	1	2	1	-1	-1	-1	-1	-1	0	
0	8	7	8	7	8	7	8	-1	-1	-1	8	7	8	7	8	7	8	-1	-1	-1	-1	-1	0	
0	1	2	1	2	1	2	-1	-1	-1	-1	7	1	2	1	2	1	2	-1	-1	-1	-1	-1	0	
0	3	5	3	5	3	5	8	-1	-1	-1	8	2	6	2	6	2	6	-1	-1	-1	-1	-1	0	
0	2	1	2	1	2	1	7	-1	-1	-1	7	1	2	1	2	1	2	-1	-1	-1	-1	-1	0	
0	3	5	3	5	3	5	8	-1	-1	-1	8	3	6	3	6	3	6	-1	-1	-1	-1	-1	0	
0	1	2	1	2	1	2	7	-1	-1	-1	7	2	1	2	1	-1	3	-1	-1	-1	-1	-1	0	
0	2	5	2	5	2	5	8	-1	-1	-1	8	3	6	3	6	-1	6	-1	-1	-1	-1	-1	0	
0	3	3	3	3	3	3	7	-1	-1	-1	7	2	1	2	1	-1	-1	-1	-1	-1	-1	-1	0	
0	2	5	2	5	2	5	8	-1	-1	-1	8	3	3	3	3	3	3	-1	-1	-1	-1	-1	0
0	0	0	0	0	0	0	0	0	0	0	0	0	0	0	0	0	0	0	0	0	0	0	0	
